1111111111111
1001000000CC1
1000000011111
1P00111E10111
1111111111111