111111111111111111111111111111111111111111111111
1000000C000C111CCCCC0000000000000000000000000001
1000000C000C1110000C0000111111111111111111111111
1000000CCCCC111CCCCC0000CCCCCCCCCCCCCCCCCCCCCCE1
10000000000C111C00000000111111111111111111111111
10000000000C000CCCCC0000000000000000000000000001
1001111100111111001000010000010000001000010C0C11
1001C00C001CCCCC0011000100001010C0001100010C0C11
1001111100111111001010010001000100001010010C0C11
10010001001CCCCC001001010011111110001001010C0C11
1001111100111111001000110100000001001000110C0C11
10000000000000000C0C0C0C0C0C0C0C0C0C0C0C0C0C0C01
100000000000000000000000000000000000000000000001
100000000000000000000000000000000000000000000001
111111111111111111111111111111110000000001111111
111111111111111100000011111111110000000001111111
1000000000000001CC11CC1111111111CCCCCCCCC1111111
1000000000000001CC11CC1111111111CCCCCCCCC1111111
1111111111111111CC11CC11111111110000000001111111
1P00CCCCCCCCCCCCCC11CC000000000000000000000000E1
111111111111111111111111111111111111111111111111
